S . W . . . W . . . . W . . . W . . . .
. . W . W . W . W W . W . W . W . W W .
. . . . W . . . . W . . . W . . . . W .
W W . W W . W W . . . W . W W . W W . .
. . . . . . . W . W . W . . . . . W . .
. W W W . W . . . W . . . W W W . . . .
. . . W . W . W . . . W . . . W . W W .
. W . . . . . W . W W W . W . . . . W .
. W . W W . W . . . . . . W . W W . . .
. . . . W . W . W W . W . . . . W . W .
W W . . . . . . . W . W . W W . . . W .
. W . W W W . W . . . . . . W . W . . .
. . . . . W . W . W W . W . . . W . W .
. W W . . . . . . . W . W . W . . . W .
. . W . W W . W W . . . . . W . W . . .
W . . . . W . . W . W W . W . . W . W .
W . W W . . . . . . . W . W . . . . W .
. . . W . W W . W W . . . . . W W . . .
. W . . . . W . . . . W W . . . W . W .
. W . W W . . . . W . . W . W . . . . T
